Mm, Mm, Mm, Mm, Ww^Wkf, Wwt, Wwt, Mm^Gvs, Ss^Bw\, Ss, Mm^Xm, Gs^Fds, Mm^Xm, Gs^Fds, Gll^Ftr, Gll^Ftr, Rp, Rp, Gll^Ftr, Hhd^Efm, Mm, Mm, Gll^Ftr, Ss^Bw\
Mm^Xm, Mm^Xm, Mm^Xm, Mm^Xm, Wwt, Wwt, Wwt, Ww, Ww, Rp, Rp, Mm^Xm, Mm^Xm, Mm^Xm, Mm^Xm, Rp, Hh^Efm, Mm, Mm, Mm, Mm, Hh, Gll^Ftr, Ss
Mm^Xm, Mm^Xm, Wwt, Wwt, Gll^Ftr, Gll^Ftr, Gll^Ftr, Ww^Wkf, Ww^Wkf, Ww, Ww, Rp, Rp, Mm^Xm, Rp, Rp, Mm^Xm, Cv, 5 Kv, Mm, Mm, Gll^Ftr, Ss, Ss
Gll^Ftr, Mm, Wwt, Gll^Ftr, Gll^Ftr, Gll^Ftr, Cvr, Ds, Hh^Efm, Ww^Wkf, Ww^Wkf, Ww, Ww, Rp, Mm, Rp, Rp, Gll^Ftr, Cv, Mm, Mm, Gll^Ftr, Gll^Ftr, Gll^Ftr
Gll^Ftr, Hh^Vhh, Wwt, Gll^Ftr, Gg^Fet, Gg^Efm, 2 Kvr^Vov, Cvr, Gll^Ftr, Mm, Mm, Ww^Wkf, Ww^Wkf, Ww, Ww, Mm, Mm, Rp, Mm, Mm, Hh^Es, Gll^Ftr, Gll^Ftr, Gll^Ftr
Mm, Ds, Wwrt, Ds, Gll^Ftr, Gg^Efm, Gll^Ftr, Sm^Dr, Gll^Ftr, Gll^Ftr, Gll^Ftr, Gg^Ve, Hh^Efm, Ww^Wkf, Ww, Ww, Mm, Rp, Rp, Mm, Mm, Hh, Hh^Efm, Gll^Ftr
Mm, Wwt, Gll^Ftr, Gs^Ft, Gll^Ftr, Gll^Ftr, Hh^Efm, Gll^Ftr, Gll^Ftr, Gll^Ftr, Gll^Ftr, Gll^Ftr, Gll^Ftr, Mm^Xm, Ww^Wkf, Ww, Ss, Rp, Hh^Efm, Rp, Rp, Hh^Efm, Gs^Efm, Hh
Mm, Wwt, Mm, Gll^Ftr, Gll^Ftr, Gll^Ftr, Gll^Ftr, Gll^Ftr, Gll^Ftr, Gll^Ftr, Gll^Ftr, Gll^Ftr, Gll^Ftr, Ww^Ewl, Wwr, Ww, Rp, Rp, Gll^Ftr, Mm, Gs^Fms, Rp, Rp, Gs^Fms
Mm, Wwt, Mm, Gll^Ftr, Gll^Ftr, Gll^Ftr, Gs^Ft, Gll^Ftr, Gs^Ft, Gll^Ftr, Gs^Ft, Gll^Ftr, Gll^Ftr, Ww^Wkf, Ch, Ww^Bsb/, Mm, Gll^Ftr, Gll^Ftr, Mm, Mm^Xm, Hhd^Efm, Rrc^Efm, Rrc
Hh, Wwt, Ds^Efm, Mm, Gll^Ftr, Gs^Ft, Rp, Gs^Ft, Rp, Gs^Ft, Rp, Gs^Ft, Rp, Ww^Bsb/, Hh^Vhh, Ww, Mm, Gll^Ftr, Gll^Ftr, Gll^Ftr, Gll^Ftr, Hh^Efm, Rrc, Gs^Fds
Mm, Wwt, Ww^Ewf, Ww^Wkf, Wwt^Bsb/, Rp, Gll^Ftr, Rp, Hh^Efm, Rp, Ss, Rp, Hh^Efm, Ww^Wkf, Sm^Gvs, Ww, Mm, Gll^Ftr, 3 Kvr^Vov, Sm^Cov, Mm^Xm, Hh^Efm, Rrc, Mm
Sm^Gvs, Ww, Wwrt^Bsb/, Wwrt^Bsb/, 1 Kh^Vov, Ww, Ww^Ewl, Gll^Ftr, Mm, Mm, Mm, Gll^Ftr, Mm, Ww^Wkf, Ww, Ww, Mm^Xm, Gll^Ftr, Gll^Ftr, Gll^Cov, Ss^Vhs, Gg^Efm, Rrc, Mm
Rp, Rp, Ww^Ewf, Wwt, Wwt, Cv, Kv, Ww^Wkf, Sm^Gvs, Gg^Fet, Ss, Mm, Ww, Mm^Xm, Ww, Ww, Ww, Mm, Mm^Xm, Gg^Fet, Ss, Ss, Ss, Rrc
Mm, Mm, Gg^Fet, Sm^Gvs, Sm^Gvs, Wwt, Wwt, Gg^Ve, Wwt, Wwt, Ww, Ww, Mm^Xm, Ww, Ww^Wkf, Ww, Ww, Ww^Wkf, Ww^Wkf, Ww^Wkf, Ww^Wkf, Ww^Ewl, Ss, Rrc
Mm, Mm, Hh, Mm, Mm, Dd^Ftd, Mm, Ww, Ss, Ss, Mm^Xm, Mm^Xm, Mm^Xm, Mm^Xm, Mm^Xm, Ww^Wkf, Ww, Ww, Wwt, Ww^Wkf, Ww^Wkf, Ss, Ss, Rrc
