Hh, Wwt, Hh^Fp, Wwt, Wwt, Wo, Ss, Rp^Es, Gs^Fms, Gs^Fms, Hh, Gll^Ftr, Md^Xm, Gll^Ftr, Gll^Ftr, Ww, Ww, Ww, Rp^Edt, Ww, Hhd^Efm, Ss, Hhd^Efm, Hhd^Efm, Wwt, Mm, Gll^Ftr, Hh, Gs^Fds, Gs^Fms, Gll^Es, Rrc^Es, Rrc, Hh^Efm, Mm, Mm, Mm
Gll^Ftr, Gll^Ftr, Gs^Fds, Mm, Ww^Wkf, Wo, Chs, Rp, Hh^Efm, Hh, Mm, Hh^Efm, Gll^Ftr, Gll^Ftr, Hd, Re^Gvs, Hhd^Gvs, Gll^Fdw, Rp^Edt, Re^Ecf, Ce^Edt, Ww^Ewf, Wwr, Ww^Ewl, Ww^Wkf, Mm, Chr, Hh, Gll^Edb, Gll^Es, Hhd, Hhd, Rrc, Hh^Efm, Hh, Mm, Md^Xm
Mm, Mm, Gs^Fds, Ds, Ww^Wkf, Wo, Rp, Rp, Mm, Mm, Hh, Gll^Ftr, Md^Xm, Hh^Efm, Gs^Fms, Gs^Vh, Gll^Edt, Gll^Fdw, Rp^Edt, 8 Ket^Vov, Ce^Edt, Mm^Edt, Mm^Edt, Ww^Wkf, Ww^Wkf, Wwrt, Hhd^Dr, Gll^Edb, Chr, 7 Khr^Vov, Gs^Fds, Hhd, Rrc, Hh^Efm, Gs^Fms, Mm, Md^Xm
Mm, Mm, Hh^Es, Ds, Ww^Wkf, Wo, Rp, Hhd^Efm, Hh, Gll^Ftr, Gll^Ftr, Mv, Gll^Ftr, Mm, Gs^Fds, Hh^Es, Gs^Fms, Rd^Edt, Rp^Edt, Gll^Fp, Hd, Hh^Efm, Rb^Gvs, Ww, Ww, Mm, Gll^Ftr, Gs^Fds, Gs^Fds, Chr, Hh^Edb, Hh, Rrc, Gs^Efm, Hh^Efm, Hhd^Gvs, Mm
Hhd^Efm, Mm, Hhd^Efm, Ww^Ewl, Wo, Wo, Rp, Gs^Fms, Cud, Md^Xm, Ww^Ewl, Gll^Ftr, Mm, Mm, Hh^Efm, Gs^Fms, Gs^Fms, Hh^Edt, Rp^Edt, Rd^Edt, Gs^Fms, Gll^Efm, Gll, Ds, Ss, Ss, Gll^Ftr, Gs^Fds, Gll^Edb, Gs^Fds, Gs^Fms, Rrc, Gs^Fms, Gs^Fms, Gs^Fds, Hd, Mm
Hhd^Efm, Hhd^Efm, Hhd^Efm, Ww, Wo, Rp^Es, Mm, 9 Kud^Vov, Cud, Mm, Wwt^Es, Mm, Rr^Vhc, Gs^Fds, Gs^Fms, Gs^Efm, Hd, Hh^Efm, Rp, Hh, Gs^Fms, Re^Gvs, Gll^Ftr, Hd, Sm^Gvs, Gll^Ftr, Hh^Efm, Gs^Fds, Gs^Fds, Gll^Es, Rrc, Rrc^Edt, Gs^Fds, Gs^Fds, Gs^Fds, Gll^Ftr, Mm
Wwt, Wwt, Wwt, Wo, Wo, Rp, Rp^Es, Gs^Fms, Hh^Efm, Gs^Fds, Wwt, Gll^Ftr, Sm^Gvs, Sm^Gvs, Gll^Ftr, Rb^Gvs, Rb^Gvs, Rd, Rp, Hh^Efm, Gs^Fms, Gll^Ftr, Gll^Ftr, Ss, Sm^Gvs, Rr^Vhc, Hh^Efm, Hh, Gs^Fms, Hh^Efm, Rrc, Hh^Edt, Gs^Fds, Gll^Ftr, Gs^Fds, Gs^Fds, Gll^Ftr
Mm, Mm, Hh, Wwt, Wo, Ww, Rp, Ds, Wwt, Hh^Efm, Wwt, Ss, Gll^Ftr, Gll^Ftr, Gll^Ftr, Gll^Ftr, Hhd^Efm, Gll^Ftr, Rp, Rp, Rp^Es, Hh^Efm, Ss, Ss, Hh, Gll^Ftr, Gs^Fms, Gs^Fms, Rrc, Rrc, Gs^Fms, Gs^Fds, Hh^Fp, Gll^Ftr, Gs^Fds, Gll^Ftr, Gll^Ftr
Mm, Mm, Mm, Mm, Wo, Ww^Wkf, Ww^Wkf, Wwt^Bw\, Rp^Bw|, Wwt, Ss, Ss, Gll^Ftr, Gll^Ftr, Gll^Ftr, Gll^Ftr, Hhd^Efm, Gll^Ftr, Rp, Hhd^Efm, Mm, Rp, Ss^Bw\, Ss, Gll^Ftr, Hh^Efm, Rp, Rrc, Mm, Gs^Fms, Gll^Ftr, Gll^Ftr, Gll^Ftr, Gll^Ftr, Mm, Hd, Mm
Mm, Mm, Mm, Mm, Wwt^Es, Wo, Wo, Mm^Gvs, Ss^Bw\, Ss, Mm^Xm, Gll^Ftr, Mm^Xm, Gll^Ftr, Gll^Ftr, Gll^Ftr, Rp, Rp, Gll^Ftr, Hhd^Efm, Mm, Mm, Gll^Ftr, Ss^Bw\, Ss^Bw/, Rp, Hhd^Gvs, Rrc, Rrc^Es, Mm, Gs^Fds, Hh^Efm, Gll^Ftr, Gll^Ftr, Mm, Mm, Mm
Mm^Xm, Mm^Xm, Mm^Xm, Mm^Xm, Ww^Wkf, Ww^Wkf, Wwt, Wo, Wo, Rp, Rp, Mm^Xm, Mm^Xm, Mm^Xm, Mm^Xm, Rp, Hh^Efm, Mm, Mm, Mm, Mm, Hh, Gll^Ftr, Ss, Gs^Fms, Hd, Hhd^Gvs, Hh^Es, Gll^Ftr, Rrc, Rrc, Gll^Ftr, Mm, Mm, Mm, Mm, Mm
Mm^Xm, Mm^Xm, Wwt, Wwt, Gll^Ftr, Gll^Ftr, Gll^Ftr, Wwt, Ww^Wkf, Wo, Wo, Rp^Es, Rp^Es, Mm^Xm, Rp, Rp, Mm^Xm, Cv, 4 Kv, Mm, Mm, Gll^Ftr, Sm^Gvs, Ss, Ss, Ww^Ewf, Ww, Ss, Ss, Gll^Ftr, Rrc, Ww^Ewf, Sm^Gvs, Mm, Mm, Mm, Mm
Gll^Ftr, Mm, Wwt, Gll^Ftr, Gll^Ftr, Gll^Ftr, Cvr, Ds, Hh^Efm, Ww^Wkf, Ww^Wkf, Wo, Wo, Rp, Mm^Xm, Rp, Rp^Es, Gll^Ftr, Cv, Mm, Mm, Sm^Gvs, Rr^Vhc, Gll^Ftr, Ss, Ww, Ww^Wkf, Ww^Wkf, Ww^Ewf, Rrc, Gg^Fet, Cvr, Sm^Gvs, Hh^Vhh, Mm, Mm^Xm, Mm^Xm
Gll^Ftr, Hh^Vhh, Ww, Gll^Ftr, Gg^Fet, Gd, 2 Kvr^Vov, Cvr, Gll^Ftr, Mm, Mm, Ww^Wkf, Ww^Wkf, Wo, Wo, Mm^Xm, Mm^Xm, Rp, Mm, Mm, Hh^Es, Gll^Ftr, Gll^Ftr, Gll^Ftr, Ss, Ww^Ewl, Wwt, Ww^Wkf, Ds^Efm, Rrc, Cvr, 6 Kvr^Vov, Sm^Gvs, Gll^Ftr, Mm, Mm^Xm, Mm^Xm
Mm, Ds, Wwrt, Ds, Gll^Ftr, Gd, Gll^Ftr, Sm^Dr, Gll^Ftr, Gll^Ftr, Gll^Ftr, Gg^Ve, Hh^Efm, Wwt, Wwt, Wo, Mm^Xm, Rp, Rp^Es, Mm, Mm, Hh, Hh^Efm, Gll^Ftr, Ds^Efm, Ww^Wkf, Wwt, Ds^Efm, Rrc^Es, Rrc^Efm, Gll^Ftr, Gll^Ftr, Mm, Mm, Mm, Mm^Xm, Mm^Xm
Mm, Wwt, Gll^Ftr, Gs^Ft, Gll^Ftr, Gll^Ftr, Hh^Efm, Gll^Ftr, Gll^Ftr, Gll^Ftr, Gll^Ftr, Gll^Ftr, Gll^Ftr, Mm, Wwt, Wo, Ss, Rp, Hh^Efm, Rp, Rp^Es, Hh^Efm, Gs^Efm, Hh, Mm, Ww^Wkf, Ww, Rrc^Es, Ds, Gs^Ftp, Gll^Ftr, Mm, Mm, Mm, Mm, Mm, Mm
Mm, Wwt, Mm, Gll^Ftr, Gll^Ftr, Gll^Ftr, Gll^Ftr, Gll^Ftr, Gll^Ftr, Gll^Ftr, Gll^Ftr, Gll^Ftr, Gll^Ftr, Ww^Ewl, Wwt, Wo, Rp, Rp, Gll^Ftr, Mm, Gs^Fms, Rp, Rp, Gs^Fms, Rrc^Efm, Rrc, Mm, Ww, Ww, Mm, Mm, Mm, Mm, Mm, Mm^Xm, Md^Xm, Md^Xm
Mm, Wwt, Mm, Gll^Ftr, Gll^Ftr, Gll^Ftr, Gs^Ft, Gll^Ftr, Gs^Ft, Gll^Ftr, Gs^Ft, Gll^Ftr, Gll^Ftr, Ww^Wkf, Ch, Ww^Bsb/, Mm, Gll^Ftr, Gll^Ftr, Mm, Mm^Xm, Hhd^Efm, Rrc^Efm, Rrc, Gs^Fds, Gs^Fds, Ce, Mm, Mm, Ww, Wwrt, Mm, Mm^Xm, Mm^Xm, Mm, Mm, Mm
Hh, Wwt, Ds^Efm, Mm, Gll^Ftr, Gs^Ft, Rp, Gs^Ft, Rp, Gs^Ft, Rp, Gs^Ft, Rp, Ww^Bsb/, Hh^Vhh, Wo, Mm, Gll^Ftr, Gll^Ftr, Gll^Ftr, Gll^Ftr, Hh^Efm, Rrc, Hh, Gs^Fds, 5 Ket, Ce, Hh, Mm, Mm, Wwrt, Mm, Mm^Xm, Mm^Xm, Md^Xm, Md^Xm, Mm
Mm, Wwt, Ww^Ewl, Ww^Wkf, Wwt^Bsb/, Rp, Gll^Ftr, Rp, Hh^Efm, Rp, Ss, Rp, Hh^Efm, Ww^Wkf, Sm^Gvs, Wo, Mm, Gll^Ftr, 3 Kvr^Vov, Sm^Cov, Mm^Xm, Hh^Efm, Rrc^Es, Mm, Mm, Gs^Fms, Gs^Fds, Mm, Mm, Mm, Mm, Ww, Ww, Ww, Ww, Ww, Ww
Sm^Gvs, Ww, Wwrt^Bsb/, Wot^Bsb/, 1 Kh^Vov, Ww, Ww, Gll^Ftr, Mm, Mm, Mm, Gll^Ftr, Mm, Ww^Es, Ww, Wo, Mm^Xm, Gll^Ftr, Gll^Ftr, Gll^Cov, Ss^Vhs, Gg^Efm, Rrc, Mm, Gll^Ftr, Gs^Fds, Gs^Fds, Mm, Mm, Mm, Mm, Gs^Fds, Mm^Xm, Gs^Fms, Gs^Fds, Gs^Fms, Gs^Fms
Rp, Rp, Hd, Wwt, Wwt, Cv, Kv, Ww^Wkf, Sm^Gvs, Hh^Efm, Ss, Mm, Ww, Mm^Xm, Ww, Wo, Ww, Mm, Mm^Xm, Gg^Fet, Ss, Ss, Ss, Rrc, Gll^Ftr, Gll^Ftr, Gll^Ftr, Mm, Mm, Mm, Mm, Mm, Mm, Mm^Xm, Mm^Xm, Md^Xm, Md^Xm
Mm, Mm, Gg^Fet, Sm^Gvs, Sm^Gvs, Wwt, Wwt, Gg^Ve, Wwt, Ww, Wwt, Ww, Mm^Xm, Ww, Ww^Es, Wo, Wo, Ww^Es, Ww^Wkf, Ww^Wkf, Ww^Wkf, Ww^Ewf, Ss, Rrc, Hh^Efm, Gll^Ftr, Gll^Ftr, Mm, Mm, Mm, Mm, Mm, Mm, Mm, Mm, Md^Xm, Md^Xm
Mm, Mm, Hh, Mm, Mm, Dd^Ftd, Mm, Ww, Ss, Ss, Mm^Xm, Mm^Xm, Mm^Xm, Mm^Xm, Mm^Xm, Ww, Ww, Wo, Wwt, Ww^Wkf, Wwt, Ss, Ss, Rrc, Gs^Fms, Hh^Efm, Hh, Mm, Mm, Mm, Mm, Mm, Mm, Mm, Mm, Mm, Mm
