Hh, Wwt, Hh^Fp, Wwt, Wwt, Wo, Ss, Rp^Es, Gs^Fms, Gs^Fms, Hh, Gll^Ftr, Md^Xm, Gll^Ftr, Gll^Ftr, Ww, Ww, Ww, Rp^Edt, Ww, Hhd^Efm, Ss, Hhd^Efm, Hhd^Efm, Wwt, Mm, Gll^Ftr, Hh, Gs^Fds, Gs^Fms, Gll^Es, Rrc^Es, Rrc, Hh^Efm, Mm, Mm, Mm
